/*

level_1.map

Background Tile Map File.
Generated by CloudBoy.

Dimensions: 20,18
Tiles: levelset.tiles

*/

/* Start of tile array. */
unsigned char level_1[] = {
	0x09, 0x0a, 0x00, 0x00, 0x00, 0x00, 0x00, 0x00,
	0x00, 0x00, 0x00, 0x00, 0x00, 0x00, 0x00, 0x00,
	0x00, 0x00, 0x00, 0x00, 0x0b, 0x0c, 0x00, 0x00,
	0x00, 0x00, 0x00, 0x00, 0x00, 0x00, 0x00, 0x00,
	0x00, 0x00, 0x00, 0x00, 0x00, 0x00, 0x00, 0x00,
	0x00, 0x00, 0x00, 0x00, 0x00, 0x00, 0x00, 0x00,
	0x09, 0x0a, 0x09, 0x0a, 0x09, 0x0a, 0x00, 0x00,
	0x09, 0x0a, 0x00, 0x00, 0x00, 0x00, 0x00, 0x00,
	0x00, 0x00, 0x00, 0x00, 0x0b, 0x0c, 0x0b, 0x0c,
	0x0b, 0x0c, 0x00, 0x00, 0x0b, 0x0c, 0x00, 0x00,
	0x00, 0x00, 0x00, 0x00, 0x09, 0x0a, 0x00, 0x00,
	0x00, 0x00, 0x00, 0x00, 0x00, 0x00, 0x01, 0x02,
	0x09, 0x0a, 0x00, 0x00, 0x00, 0x00, 0x00, 0x00,
	0x0b, 0x0c, 0x00, 0x00, 0x00, 0x00, 0x00, 0x00,
	0x00, 0x00, 0x03, 0x04, 0x0b, 0x0c, 0x00, 0x00,
	0x00, 0x00, 0x00, 0x00, 0x09, 0x0a, 0x00, 0x00,
	0x00, 0x00, 0x00, 0x00, 0x00, 0x00, 0x09, 0x0a,
	0x00, 0x00, 0x00, 0x00, 0x00, 0x00, 0x00, 0x00,
	0x0b, 0x0c, 0x00, 0x00, 0x00, 0x00, 0x00, 0x00,
	0x00, 0x00, 0x0b, 0x0c, 0x00, 0x00, 0x00, 0x00,
	0x00, 0x00, 0x00, 0x00, 0x00, 0x00, 0x00, 0x00,
	0x00, 0x00, 0x00, 0x00, 0x00, 0x00, 0x00, 0x00,
	0x09, 0x0a, 0x00, 0x00, 0x00, 0x00, 0x00, 0x00,
	0x00, 0x00, 0x00, 0x00, 0x00, 0x00, 0x00, 0x00,
	0x00, 0x00, 0x00, 0x00, 0x0b, 0x0c, 0x00, 0x00,
	0x00, 0x00, 0x09, 0x0a, 0x00, 0x00, 0x00, 0x00,
	0x00, 0x00, 0x00, 0x00, 0x00, 0x00, 0x00, 0x00,
	0x09, 0x0a, 0x00, 0x00, 0x00, 0x00, 0x0b, 0x0c,
	0x00, 0x00, 0x00, 0x00, 0x00, 0x00, 0x00, 0x00,
	0x00, 0x00, 0x00, 0x00, 0x0b, 0x0c, 0x00, 0x00,
	0x00, 0x00, 0x00, 0x00, 0x00, 0x00, 0x00, 0x00,
	0x09, 0x0a, 0x01, 0x02, 0x00, 0x00, 0x00, 0x00,
	0x00, 0x00, 0x00, 0x00, 0x00, 0x00, 0x00, 0x00,
	0x00, 0x00, 0x00, 0x00, 0x0b, 0x0c, 0x03, 0x04,
	0x00, 0x00, 0x00, 0x00, 0x00, 0x00, 0x00, 0x00,
	0x00, 0x00, 0x09, 0x0a, 0x09, 0x0a, 0x09, 0x0a,
	0x00, 0x00, 0x00, 0x00, 0x09, 0x0a, 0x09, 0x0a,
	0x00, 0x00, 0x00, 0x00, 0x00, 0x00, 0x0b, 0x0c,
	0x0b, 0x0c, 0x0b, 0x0c, 0x00, 0x00, 0x00, 0x00,
	0x0b, 0x0c, 0x0b, 0x0c, 0x00, 0x00, 0x00, 0x00,
	0x00, 0x00, 0x00, 0x00, 0x00, 0x00, 0x00, 0x00,
	0x00, 0x00, 0x00, 0x00, 0x00, 0x00, 0x00, 0x00,
	0x00, 0x00, 0x00, 0x00, 0x00, 0x00, 0x00, 0x00,
	0x00, 0x00, 0x00, 0x00, 0x00, 0x00, 0x00, 0x00,
	0x00, 0x00, 0x00, 0x00, 0x00, 0x00, 0x00, 0x00
};
/* End of level_1.C */
