/*

level_5.map

Background Tile Map File.
Generated by CloudBoy.

Dimensions: 20,18
Tiles: levelset.tiles

*/

/* Start of tile array. */
unsigned char level_5[] = {
	0x01, 0x02, 0x01, 0x02, 0x01, 0x02, 0x01, 0x02,
	0x01, 0x02, 0x01, 0x02, 0x01, 0x02, 0x01, 0x02,
	0x01, 0x02, 0x01, 0x02, 0x03, 0x04, 0x03, 0x04,
	0x03, 0x04, 0x03, 0x04, 0x03, 0x04, 0x03, 0x04,
	0x03, 0x04, 0x03, 0x04, 0x03, 0x04, 0x03, 0x04,
	0x01, 0x02, 0x11, 0x12, 0x01, 0x02, 0x01, 0x02,
	0x01, 0x02, 0x01, 0x02, 0x01, 0x02, 0x11, 0x12,
	0x01, 0x02, 0x01, 0x02, 0x03, 0x04, 0x13, 0x14,
	0x03, 0x04, 0x03, 0x04, 0x03, 0x04, 0x03, 0x04,
	0x03, 0x04, 0x13, 0x14, 0x03, 0x04, 0x03, 0x04,
	0x01, 0x02, 0x01, 0x02, 0x01, 0x02, 0x01, 0x02,
	0x01, 0x02, 0x01, 0x02, 0x01, 0x02, 0x01, 0x02,
	0x01, 0x02, 0x01, 0x02, 0x03, 0x04, 0x03, 0x04,
	0x03, 0x04, 0x03, 0x04, 0x03, 0x04, 0x03, 0x04,
	0x03, 0x04, 0x03, 0x04, 0x03, 0x04, 0x03, 0x04,
	0x01, 0x02, 0x01, 0x02, 0x01, 0x02, 0x19, 0x1a,
	0x01, 0x02, 0x19, 0x1a, 0x01, 0x02, 0x01, 0x02,
	0x01, 0x02, 0x01, 0x02, 0x03, 0x04, 0x03, 0x04,
	0x03, 0x04, 0x1b, 0x1c, 0x03, 0x04, 0x1b, 0x1c,
	0x03, 0x04, 0x03, 0x04, 0x03, 0x04, 0x03, 0x04,
	0x01, 0x02, 0x01, 0x02, 0x01, 0x02, 0x01, 0x02,
	0x01, 0x02, 0x01, 0x02, 0x01, 0x02, 0x01, 0x02,
	0x01, 0x02, 0x01, 0x02, 0x03, 0x04, 0x03, 0x04,
	0x03, 0x04, 0x03, 0x04, 0x03, 0x04, 0x03, 0x04,
	0x03, 0x04, 0x03, 0x04, 0x03, 0x04, 0x03, 0x04,
	0x01, 0x02, 0x01, 0x02, 0x01, 0x02, 0x19, 0x1a,
	0x01, 0x02, 0x19, 0x1a, 0x01, 0x02, 0x01, 0x02,
	0x01, 0x02, 0x01, 0x02, 0x03, 0x04, 0x03, 0x04,
	0x03, 0x04, 0x1b, 0x1c, 0x03, 0x04, 0x1b, 0x1c,
	0x03, 0x04, 0x03, 0x04, 0x03, 0x04, 0x03, 0x04,
	0x01, 0x02, 0x01, 0x02, 0x01, 0x02, 0x01, 0x02,
	0x01, 0x02, 0x01, 0x02, 0x01, 0x02, 0x01, 0x02,
	0x01, 0x02, 0x01, 0x02, 0x03, 0x04, 0x03, 0x04,
	0x03, 0x04, 0x03, 0x04, 0x03, 0x04, 0x03, 0x04,
	0x03, 0x04, 0x03, 0x04, 0x03, 0x04, 0x03, 0x04,
	0x01, 0x02, 0x11, 0x12, 0x01, 0x02, 0x01, 0x02,
	0x01, 0x02, 0x01, 0x02, 0x01, 0x02, 0x11, 0x12,
	0x01, 0x02, 0x01, 0x02, 0x03, 0x04, 0x13, 0x14,
	0x03, 0x04, 0x03, 0x04, 0x03, 0x04, 0x03, 0x04,
	0x03, 0x04, 0x13, 0x14, 0x03, 0x04, 0x03, 0x04,
	0x01, 0x02, 0x01, 0x02, 0x01, 0x02, 0x01, 0x02,
	0x01, 0x02, 0x01, 0x02, 0x01, 0x02, 0x01, 0x02,
	0x01, 0x02, 0x01, 0x02, 0x03, 0x04, 0x03, 0x04,
	0x03, 0x04, 0x03, 0x04, 0x03, 0x04, 0x03, 0x04,
	0x03, 0x04, 0x03, 0x04, 0x03, 0x04, 0x03, 0x04
};
/* End of level_5.C */
