/*

level_1.map

Background Tile Map File.
Generated by CloudBoy.

Dimensions: 20,18
Tiles: background.tiles

*/

/* Start of tile array. */
unsigned char level_1[] = {
	0x18, 0x19, 0x00, 0x00, 0x00, 0x00, 0x00, 0x00,
	0x00, 0x00, 0x00, 0x00, 0x00, 0x00, 0x00, 0x00,
	0x00, 0x00, 0x00, 0x00, 0x1a, 0x1b, 0x00, 0x00,
	0x00, 0x00, 0x00, 0x00, 0x00, 0x00, 0x00, 0x00,
	0x00, 0x00, 0x00, 0x00, 0x00, 0x00, 0x00, 0x00,
	0x00, 0x00, 0x00, 0x00, 0x18, 0x19, 0x00, 0x00,
	0x00, 0x00, 0x18, 0x19, 0x00, 0x00, 0x00, 0x00,
	0x00, 0x00, 0x00, 0x00, 0x00, 0x00, 0x00, 0x00,
	0x1a, 0x1b, 0x00, 0x00, 0x00, 0x00, 0x1a, 0x1b,
	0x00, 0x00, 0x00, 0x00, 0x00, 0x00, 0x00, 0x00,
	0x00, 0x00, 0x00, 0x00, 0x18, 0x19, 0x00, 0x00,
	0x18, 0x19, 0x00, 0x00, 0x00, 0x00, 0x00, 0x00,
	0x18, 0x19, 0x00, 0x00, 0x00, 0x00, 0x00, 0x00,
	0x1a, 0x1b, 0x00, 0x00, 0x1a, 0x1b, 0x00, 0x00,
	0x00, 0x00, 0x00, 0x00, 0x1a, 0x1b, 0x00, 0x00,
	0x00, 0x00, 0x00, 0x00, 0x18, 0x19, 0x00, 0x00,
	0x00, 0x00, 0x00, 0x00, 0x00, 0x00, 0x10, 0x11,
	0x18, 0x19, 0x00, 0x00, 0x00, 0x00, 0x00, 0x00,
	0x1a, 0x1b, 0x00, 0x00, 0x00, 0x00, 0x00, 0x00,
	0x00, 0x00, 0x12, 0x13, 0x1a, 0x1b, 0x00, 0x00,
	0x00, 0x00, 0x18, 0x19, 0x00, 0x00, 0x00, 0x00,
	0x00, 0x00, 0x00, 0x00, 0x00, 0x00, 0x18, 0x19,
	0x00, 0x00, 0x00, 0x00, 0x00, 0x00, 0x1a, 0x1b,
	0x00, 0x00, 0x00, 0x00, 0x00, 0x00, 0x00, 0x00,
	0x00, 0x00, 0x1a, 0x1b, 0x00, 0x00, 0x00, 0x00,
	0x00, 0x00, 0x00, 0x00, 0x00, 0x00, 0x00, 0x00,
	0x00, 0x00, 0x18, 0x19, 0x18, 0x19, 0x00, 0x00,
	0x00, 0x00, 0x00, 0x00, 0x00, 0x00, 0x00, 0x00,
	0x00, 0x00, 0x00, 0x00, 0x00, 0x00, 0x1a, 0x1b,
	0x1a, 0x1b, 0x00, 0x00, 0x00, 0x00, 0x00, 0x00,
	0x00, 0x00, 0x00, 0x00, 0x00, 0x00, 0x00, 0x00,
	0x00, 0x00, 0x00, 0x00, 0x00, 0x00, 0x00, 0x00,
	0x00, 0x00, 0x00, 0x00, 0x00, 0x00, 0x00, 0x00,
	0x00, 0x00, 0x00, 0x00, 0x00, 0x00, 0x00, 0x00,
	0x00, 0x00, 0x00, 0x00, 0x00, 0x00, 0x00, 0x00,
	0x00, 0x00, 0x10, 0x11, 0x00, 0x00, 0x00, 0x00,
	0x00, 0x00, 0x00, 0x00, 0x00, 0x00, 0x00, 0x00,
	0x00, 0x00, 0x00, 0x00, 0x00, 0x00, 0x12, 0x13,
	0x00, 0x00, 0x00, 0x00, 0x00, 0x00, 0x00, 0x00,
	0x00, 0x00, 0x00, 0x00, 0x00, 0x00, 0x00, 0x00,
	0x00, 0x00, 0x00, 0x00, 0x00, 0x00, 0x18, 0x19,
	0x00, 0x00, 0x00, 0x00, 0x00, 0x00, 0x00, 0x00,
	0x00, 0x00, 0x18, 0x19, 0x00, 0x00, 0x00, 0x00,
	0x00, 0x00, 0x1a, 0x1b, 0x00, 0x00, 0x00, 0x00,
	0x00, 0x00, 0x00, 0x00, 0x00, 0x00, 0x1a, 0x1b
};
/* End of level_1.C */
